border_size=1
usage=map

Ss          , Ss          , Ss          , Ss          , Ss          , Ss          , Ss          , Ss          , Ss          , Ss          , Ss          , Ss          , Ss          , Ss          , Ss          , Ss          , Ss          , Ss          , Ss          , Gs          , Gs          , Gs          , Gs          , Gs          , Ss          , Ss          , Ss          , Gs          , Gs          , Gs          , Ss          , Ss          , Ss          , Gs          
Ww          , Ss          , Ss          , Ss          , Ss          , Ss          , Ss          , Ss          , Ss          , Ss^Vm       , Ss          , Ss          , Ss          , Ss          , Ss          , Ss          , Ss          , Ss          , Ss          , Ss          , Ss          , Ss          , Ss          , Ss          , Ss          , Ss^Vm       , Ss          , Ss          , Ss          , Ss          , Ss          , Ss          , Ss          , Ss          
Ww          , Ww          , Ww          , Ww          , Ww          , Ww          , Ww          , Ww          , Ww          , Ss          , Ww          , Ww          , Ww          , Ww          , Ww          , Ww          , Ww          , Ww^Vm       , Ww          , Ss          , Ww          , Ss          , Ww          , Ss          , Ww          , Ss          , Ww          , Ss          , Ww          , Ss          , Ww          , Ss          , Ww          , Ss          
Wo          , Ww          , Wo          , Ww          , Wo          , Ww          , Ww          , Ww          , Ww          , Ww          , Ww          , Ww          , Ww          , Ww          , Ww          , Ww          , Ww          , Ww          , Ww          , Ww          , Ww          , Ww          , Ww          , Ww          , Ww          , Ww          , Ww          , Ww          , Ww          , Ww          , Ww          , Ww          , Ww          , Ww          
Wot         , Wo          , Wot         , Wo          , 1 Wot       , Wo          , Wo          , Wo          , Wo          , Wo          , Wo          , Wo          , Wo          , Wo          , Wo          , Wo          , Wo          , Wo          , Wo          , Wo          , Wo          , Ww          , Wo          , Ww          , Wo          , Ww          , Wo          , Wo          , Wo          , Ww          , Wo          , Ww          , Wo          , Ww          
Ww          , Wot         , Ww          , Wot         , Wo          , Wot         , Wo          , Wot         , Wot         , Wot         , Wo          , Wo          , Wo          , Wo          , Wo          , Wot         , Wot         , Wot         , Wot         , Wot         , Wot         , Wo          , Wo          , Wo          , Wot         , Wo          , Wot         , Wo          , Wo          , Wo          , Wo          , Wo          , Wo          , Wo          
Ww          , Ww          , Ww          , Ww          , Ww          , Ww          , Ww          , Wo          , Ww          , Wo          , Ww          , Ww          , Ww          , Ww          , Ww          , Wo          , Wo          , Wot         , Wo          , Wot         , Wo          , Wot         , Wot         , Wot         , Wot         , Wot         , Wot         , Wot         , Wo          , Wo          , Ww          , Wo          , Ww          , Wo          
Ww          , Ww          , Ww          , Ww          , Ww          , Ww          , Ww          , Ww          , Ww          , Ww          , Ww          , Ww          , Ww          , Ww          , Ww          , Ww          , Ww          , Wo          , Ww          , Wo          , Ww          , Wo          , Wo          , Wo          , Wo          , Wo          , Wo          , Wo          , Ww          , Ww          , Ww          , Ww          , Ww          , Ww          
Ds          , Ds          , Ds          , Ww          , Ds          , Ww          , Ds          , Ww          , Ww          , Ww          , Ds          , Ww          , Ds          , Ww          , Ds          , Ds          , Ds          , Ds          , Ds          , Ww          , Ds          , Ww          , Ww          , Ww          , Ww          , Ww          , Ww          , Ww          , Ds          , Ww          , Ds          , Ww          , Ww          , Ww          
Hh^Fmw      , Hh^Fmw      , Hh^Fmw      , Ds          , Gs^Fmw      , Ds          , Ds          , Ds          , Ww          , Ds          , Hh^Fms      , Ds          , Gs^Fmw      , Ds          , Gs^Fmw      , Hh^Fms      , Hh^Fms      , Hd          , Hd          , Ds          , Ww          , Ww          , Ds          , Ds          , Ds          , Ds          , Ds          , Ds          , Gs^Fmw      , Ds          , Gs^Fmw      , Ds          , Ds          , Ds          
Mm          , Hh^Fmw      , Hh^Fmw      , Hh^Fmw      , Hh^Fmw      , Hh^Vhh      , Ww          , Ww          , Ss          , Hh^Fmw      , Hh^Fms      , Hh^Fms      , Hh^Fmw      , Hh^Fmw      , Mm          , Mm          , Mm          , Hh^Fmw      , Hh^Fmw      , Ds          , Ww          , Ds          , Hh^Fmw      , Ds          , Hh^Fmw      , Ds          , Hh^Fmw      , Hh^Fmw      , Hh^Fmw      , Hh^Fmw      , Hh^Fmw      , Hh^Fmw      , Hh^Fmw      , Hh^Fmw      
Mm          , Mm          , Mm          , Mm          , Mm          , Hh^Fmw      , Ww          , Hh^Fmw      , Ss          , Hh^Fds      , Hh^Fp       , Mm          , Mm          , Ss          , Mm          , Mm^Xm       , Mm          , Mm          , Ww          , Ww          , Mm          , Hh^Fmw      , Mm          , Hh^Fmw      , Hh^Vhh      , Hh^Fmw      , Mm          , Mm          , Mm          , Mm          , Mm          , Hh^Fmw      , Mm          , Hh^Fmw      
Mm^Xm       , Mm^Xm       , Mm          , Mm          , Ss          , Ww          , Ss          , Mm          , Ss          , Ss          , Hh^Fp       , Mm          , Mm          , Ss          , Mm          , Mm^Xm       , Mm          , Mm          , Ww          , Mm          , Mm          , Mm          , Mm          , Mm          , Mm          , Hh^Fms      , Mm          , Mm          , Mm          , Mm          , Mm          , Mm          , Hh^Fds      , Mm          
Mm          , Mm          , Hh^Fp       , Mm          , Mm          , Ww          , Ss          , Mm          , Ss          , Mm          , Mm          , Mm^Vhh      , Mm          , Ss          , Mm          , Mm          , Mm          , Hh^Fms      , Mm          , Ww          , Ww          , Hh^Fds      , Hh^Fms      , Hh^Fms      , Mm          , Hh^Fms      , Mm          , Mm          , Mm^Xm       , Mm^Xm       , Mm          , Mm          , Hh^Fds      , Hh^Fms      
Mm          , Hh^Fp       , Ss          , Ss          , Ww          , Ww          , Hh^Fms      , Ss          , Mm          , Mm          , Ss          , Mm          , Hh^Fms      , Ss          , Ss          , Ss          , Ss          , Hh^Fms      , Mm          , Mm          , Ww          , Ww          , Hh^Fds      , Mm          , Mm          , Mm          , Mm^Xm       , Mm^Xm       , Mm          , Mm          , Mm          , Mm          , Mm          , Mm          
Mm          , Mm          , Ss^Vhs      , Mm          , Ww          , Mm          , Mm          , Ss          , Hh^Fms      , Ss          , Mm          , Ss          , Mm          , Mm          , Hh^Fmw      , Mm          , Mm          , Mm          , Mm          , Ww          , Ss          , Ww          , Ww          , Hh^Fds      , Mm          , Mm          , Mm          , Mm          , Mm          , Mm^Vhh      , Mm          , Mm          , Mm          , Mm          
Mm          , Ss          , Ss          , Mm          , Ww          , Mm          , Hh^Fmw      , Mm          , Hh^Fmw      , Mm          , Mm^Xm       , Ss          , Ss          , Mm          , Mm          , Mm          , Mm          , Mm          , Ww          , Ww          , Ss          , Ss          , Ww          , Hh^Fds      , Mm          , Mm^Xm       , Mm          , Mm          , Mm          , Mm          , Mm          , Mm          , Mm          , Mm          
Mm          , Mm          , Mm          , Ww          , Mm          , Ss          , Ss          , Ss          , Mm          , Mm          , Mm          , Mm          , Ss          , Mm          , Mm^Xm       , Mm          , Mm          , Mm          , Ww          , Mm          , Mm          , Mm          , Ww          , Hh^Fds      , Mm          , Mm^Xm       , Mm          , Hh^Fds      , Cv          , Co          , Co          , Mm          , Mm          , Mm          
Mm          , Hh^Fms      , Mm          , Ww          , Mm          , Mm          , Hh^Fds      , Mm          , Mm          , Hh^Vhh      , Ss          , Ss          , Mm          , Hh^Fdw      , Mm^Xm       , Hh^Fmw      , Mm          , Ww          , Mm          , Hh^Fdw      , Mm          , Mm          , Ww          , Hh^Fds      , Mm          , Mm^Xm       , Mm          , Hh^Fds      , Cv          , 2 Ke        , Co          , Mm          , Mm          , Mm          
Mm          , Hh^Fms      , Ww          , Ww          , Mm          , Mm          , Mm          , Hh^Fds      , Mm          , Mm          , Mm          , Ss          , Ss          , Mm          , Mm          , Mm          , Ww          , Ww          , Mm          , Hh^Fdw      , Mm          , Mm          , Hh^Fds      , Ww          , Hh^Fds      , Mm          , Mm          , Hh^Fds      , Hh^Fds      , Co          , Mm          , Mm          , Mm          , Mm          
Mm          , Mm          , Ww          , Mm          , Mm          , Mm^Xm       , Mm          , Hh^Fds      , Hh^Fds      , Mm          , Mm^Xm       , Mm          , Mm          , Ss          , Mm          , Mm          , Ww          , Mm          , Mm          , Mm          , Mm          , Mm^Vhh      , Mm          , Ww          , Ww          , Mm          , Mm^Xm       , Mm          , Mm          , Hh^Fds      , Hh^Fds      , Hh^Vhh      , Hh^Fds      , Hh^Fds      
Mm          , Mm          , Ww          , Mm          , Mm          , Mm^Xm       , Mm^Xm       , Mm          , Mm          , Mm          , Mm^Xm       , Mm^Xm       , Mm          , Ss          , Mm          , Ww          , Mm          , Mm          , Mm          , Mm          , Mm          , Mm          , Mm          , Mm          , Ww          , Mm          , Mm^Xm       , Mm          , Mm          , Hh^Fds      , Hh^Fds      , Hh^Fds      , Hh^Fds      , Hh^Fds      
