border_size=1
usage=map

Gg          , Gg          , Gg          , Ai          , Ai          , Ai          , Ai          , Aa          , Gg          , Gg          , Aa          , Aa          , Aa          , Aa          , Aa          , Gs          , Aa          , Gs          , Aa          , Aa          , Gs          , Gs          , Gg          , Re          , Gg          , Gs          , Aa          , Gg          , Gg          , Gg          , Gs^Fmw      , Gg          , Gg          , Gg          , Gg          
Gs          , Gg          , Gg^Vo       , Gg          , Gg          , Ai          , Ai          , Aa          , Gg          , Aa          , Aa          , Gs          , Gs          , Aa          , Gs          , Gs          , Gs          , Gs          , Aa          , Aa          , Gg          , Gg          , Re          , Re          , Gg          , Gs          , Aa          , Aa          , Ss          , Gs^Fmw      , Gs^Fmw      , Gs^Fmw      , Gg          , Aa          , Aa          
Ai          , Gs          , Gs          , Gs          , Gs          , Ai          , Ai          , Gs          , Gs^Fmw      , Gs^Fmw      , Gs^Fmw      , Aa          , Aa          , Aa          , Gg          , Gg^Vo       , Aa          , Gs          , Gs^Fmw      , Gs^Fmw      , Gs^Fdw      , Gg          , Re          , Gg          , Gs          , Gs          , Aa          , Aa          , Ss          , Ce          , 4 Ke        , Ce          , Gg          , Aa          , Gs          
Ww          , Ai          , Ai          , Ai          , Ai          , Ai          , Aa          , Gs          , Gg          , Gs^Fmw      , Gg          , Gs^Fmw      , Gg          , Gg          , Gs          , Gs          , Ce          , Ce          , Ce          , Hh^Fmw      , Gg          , Gg          , Re          , Gg          , Aa          , Aa          , Aa          , Ss          , Ss          , Ce          , Ce          , Ce          , Gg          , Gs          , Gs          
Ww          , Ww          , Ww          , Ww          , Ww          , Ai          , Gs          , Gs          , Gg^Vo       , Gg          , Gg          , Gg          , Gg          , Gs^Fdw      , Gs^Fdw      , Gg          , Ce          , 3 Ke        , Ce          , Gs^Fmw      , Gg          , Re          , Gg          , Gg          , Aa          , Aa^Voa      , Aa          , Aa          , Ss          , Gs          , Aa          , Gg          , Gg          , Gs          , Gs          
Wo          , Ww          , Wo          , Ww          , Ww          , Ww          , Ww          , Gs          , Gs          , Gs          , Gs          , Gs          , Gs          , Gg          , Gg          , Gg          , Gg          , Ce          , Gg          , Gg          , Re          , Re          , Gg          , Gg          , Gs          , Aa          , Aa          , Ss^Bw\      , Gs          , Gs          , Aa          , Aa          , Gg          , Gg          , Gs          
Wo          , Wo          , Wo          , Wo          , Wo          , Ww          , Ww          , Ww          , Ww          , Ww          , Ww          , Wwf         , Wwf         , Gs          , Gs          , Gs          , Gs          , Gg          , Gg          , Ai          , Re          , Gg          , Ce          , Gg          , Ai          , Ai          , Aa          , Ss          , Ss          , Gs          , Gs          , Aa          , Gg          , Gg          , Gs^Fdw      
Ww          , Wo          , Wo          , Wo          , Wo          , Wo          , Wo          , Ww          , Ww          , Ww          , Ww          , Ww          , Ww          , Wwf         , Ww          , Wwf         , Wwf         , Gg          , Ds          , Ds          , Rd          , Gg          , Gg          , Gg          , Ai          , Ai          , Aa          , Aa          , Ss          , Ss          , Gs          , Gg          , Gg^Vo       , Gg          , Gs^Fdw      
Ai          , Ww          , Ww          , Ww          , Ww          , Wo          , Wo          , Wo          , Wo          , Wo          , Wo          , Wo          , Wo          , Wwf         , Wwf         , Ww          , Ww          , Ds          , Ds          , Ds          , Rd          , Ds          , Ss          , Ai          , Ds          , Gs          , Ss^Vm       , Ss          , Gs          , Gs          , Aa          , Gg          , Gg          , Gg          , Gg          
Ai          , Ww          , Ai          , Ww          , Ww          , Ww          , Ww          , Wo          , Wo          , Wo          , Wo          , Wo          , Wo          , Wwr         , Wo          , Ww          , Wwf         , Ww          , Wwf^Bw/     , Rd          , Ds          , Ds          , Ds          , Wwf         , Wwf         , Ss          , Ss          , Gs          , Ce          , Gs          , Aa          , Aa          , Gs^Fdw      , Gs^Fmw      , Gs^Fdw      
Ai          , Ww          , Ai          , Ai          , Ai          , Ww          , Ww          , Ww          , Ww          , Ww          , Ww          , Wo          , Wo          , Wo          , Wo          , Wwr         , Ww^Bw/      , Ww^Bw/      , Wwf         , Wwf         , Wwf         , Ds          , Dd^Vdt      , Ds          , Wwf         , Ds          , Ds          , Ds          , Gs^Fmw      , Gs^Fmw      , Gs^Fdw      , Gs^Fmw      , Gs^Fdw      , Gs^Fmw      , Gs^Fdw      
Aa          , Ai          , Aa          , Aa          , Aa          , Ai          , Wwf         , Ww          , Wwf         , Ww          , Wwf         , Ww          , Wwf         , Wo          , Wo^Bw/      , Wo^Bw/      , Wo          , Wwf         , Ww          , Wwf         , Wwf         , Ds          , Ds          , Ds          , Ds          , Wwf         , Ds          , Ds          , Ds          , Gs^Fdw      , Gg          , Gg          , Gg          , Gs^Fdw      , Gg          
Aa          , Aa          , Aa          , Aa^Vha      , Aa          , Aa          , Gs          , Gs          , Gs          , Wwf         , Wwf         , Wwf         , Ww^Bw/      , Wwf^Bw/     , Wwf         , Wo          , Wo          , Wo          , Wo          , Ww          , Ww          , Wwf         , Wwf         , Ds          , Ds          , Wwf         , Ds          , Ce          , Ds          , Gs          , Gs          , Gg^Vo       , Gs          , Gs^Fmw      , Gg          
Ai          , Aa          , Ai          , Aa          , Aa          , Gs          , Gs          , Ce          , Gs          , Gs          , Re          , Wwf^Bw/     , Wwf         , Wwf         , Ww^Vm       , Ww          , Wo          , Wo          , Wo          , Ww          , Ww          , Ww          , Wwf         , Wwf         , Wwf         , Wwf         , Ds          , Ce          , Ce          , Ds          , Ds          , Gs          , Gs          , Gs          , Gs          
Ai          , Ai          , Aa          , Aa          , Gs          , Aa          , Gg          , Gs          , Re          , Re          , Gs          , Gs          , Gs          , Wwf         , Wwf         , Wwf         , Ww          , Ww          , Wo          , Wo          , Wo          , Ww          , Ww          , Ww          , Ww          , Wwf         , Wwf         , Ds          , Ds          , Ke          , Ce          , Gs          , Gs          , Aa          , Aa          
Aa          , Ai          , Aa          , Gs          , Gs          , Gg          , Re          , Re          , Gg          , Gg          , Gg          , Ce          , Gg          , Gs          , Gs          , Wwf         , Wwf         , Ww          , Ww          , Wo          , Wo          , Wo          , Ww          , Ww          , Ww          , Wwf         , Ww          , Wwf         , Ww          , Ds          , Ds          , Ce          , Gs          , Aa          , Gs          
Aa          , Aa          , Gs          , Gs          , Gg          , Re          , Gg          , Gg          , Ce          , Gs          , Gs          , Gg          , Gg          , Gg          , Gs          , Wwf         , Wwf         , Ww          , Ww          , Ww          , Wo          , Wo          , Wo          , Wo          , Ww          , Ww          , Ww          , Ww          , Ww^Vm       , Ww          , Wwf         , Ds          , Ds          , Gs          , Gs          
Aa          , Aa          , Gs          , Gg^Vc       , Gg          , Re          , Gg          , Ce          , 2 Ke        , Ce          , Gs          , Aa          , Aa          , Aa          , Aa          , Gs          , Gs          , Ww          , Ww          , Ww          , Ww          , Wo          , Ww          , Wo          , Wo          , Wo          , Ww          , Ww          , Ww          , Ww          , Ww          , Wwf         , Ds          , Gs          , Gs          
Aa          , Gs          , Gg          , Gg          , Re          , Re          , Gg          , Ce          , Ce          , Ce          , Gg          , Aa          , Aa          , Aa^Vha      , Aa          , Gs          , Ww          , Ww          , Ww          , Ww          , Ww          , Ww          , Ww          , Wo          , Ww          , Wo          , Wo          , Wo          , Ww          , Ww          , Ww          , Ww          , Ww          , Ds          , Ds          
Gg          , Aa          , Gg          , Re          , Gs          , Gs          , Gg          , Gg          , Gg          , Gg          , Gs          , Gs          , Aa          , Aa          , Gs          , Gs          , Gs          , Gs          , Gs          , Wwf         , Wwf         , Ww          , Ww          , Ww          , Ww          , Wo          , Wo          , Wo          , Wo          , Wo          , Ww          , Ww          , Ww          , Ds          , Ds          
Aa          , Gg          , Gs          , Re          , Gg          , Aa          , Aa          , Aa          , Aa          , Gg          , Gg          , Gs          , Gs          , Aa          , Gs          , Gg          , Aa          , Aa          , Aa          , Gs          , Gs          , Wwf         , Ww          , Ww          , Ww          , Ww          , Ww          , Ww          , Wo          , Wo          , Wo          , Ww          , Ww          , Ww          , Ww          
Gg          , Gg          , Gs          , Re          , Gs          , Gg          , Aa          , Aa          , Aa^Vha      , Aa          , Aa          , Gs          , Gs          , Aa          , Gg          , Gg          , Aa          , Aa          , Gs          , Gs          , Gs          , Ds          , Ds          , Ww          , Ww          , Ww          , Ww          , Ww          , Wo          , Wo          , 1 Wo        , Wo          , Wo          , Ww          , Ww          
Gg          , Gs          , Re          , Re          , Gs          , Gs          , Aa          , Aa          , Aa          , Aa          , Gs          , Gs          , Gs          , Aa          , Gg          , Gg          , Gs          , Aa          , Aa^Vha      , Gg          , Gg          , Gs          , Gs          , Ds          , Ds          , Ww          , Ww          , Ww          , Ww          , Wo          , Wo          , Wo          , Wo          , Wo          , Wo          
Gs          , Re          , Gs          , Gs          , Aa          , Gs          , Aa          , Aa          , Aa          , Gs          , Gg          , Gg          , Gg          , Gs          , Gs          , Gs          , Aa          , Aa          , Aa          , Aa          , Gg          , Aa          , Gg          , Ds          , Ds          , Ds          , Ds          , Ww          , Ww          , Ww          , Ww          , Wo          , Wo          , Wo          , Wo          
Gs          , Re          , Gg          , Gs          , Gs          , Aa          , Aa          , Aa          , Aa          , Gs          , Gg          , Gg^Vc       , Gg          , Gs          , Aa          , Aa          , Gs          , Aa          , Aa          , Aa          , Gg          , Gg          , Gg          , Gg          , Ds          , Dd^Vdt      , Ds          , Ww          , Ww          , Ww          , Ww          , Ww          , Wo          , Wo          , Wo          
Gg          , Re          , Gg          , Gg          , Gg          , Aa          , Gg          , Gg          , Gg          , Gg          , Gg          , Gg          , Gg          , Gg          , Aa          , Aa          , Gs          , Gs          , Aa          , Gg          , Gg          , Gg          , Gg          , Gg          , Gg          , Ds          , Ds          , Ds          , Ds          , Ww          , Ww          , Ww          , Ww          , Ww          , Ww          
