border_size=1
usage=map

Gg          , Gs^Fmf      , Gs^Fmf      , Hh^Fp       , Gs^Fmf      , Gs^Fmf      , Gg          , Gg          , Gg          , Gs          , Gs          , Gg          , Gs^Fdw      , Hh^Fdw      , Ha^Fma      , Ha^Fma      , Ha^Fma      , Ha^Fma      , Ms          , Ms          , Ms          , Ms          , Ms          , Hh^Fmf      , Ha^Fma      , Ms          , Ms          , Ms          , Ms          , Ms          , Ms          , Ms          , Ms          , Ms          
Gg          , Gg          , Gs^Fmf      , Gs^Fmf      , Gg          , Gg          , Gg          , Gg          , Ce          , Gg          , Gg          , Gg          , Gg          , Hh^Fdw      , Hh^Fdw      , Ha^Fma      , Ha^Fma      , Ha^Fma      , Ha^Fma      , Ms          , Ha^Fma      , Ms          , Ms          , Ms          , Ms          , Ha^Fma      , Ms          , Ms          , Ms          , Ms          , Ms          , Ms          , Ms          , Ms          
Gg          , Gg          , Gg          , Gs^Fmf      , Gs^Fmf      , Gs^Fmf      , Gs^Fmf      , Ce          , 3 Ke        , Ce          , Gs^Fmf      , Gg          , Gg^Vo       , Gg          , Gg          , Ha^Fma      , Ha^Fma      , Ha^Fma      , Gs^Fdw      , Ha^Fma      , Gs^Fdw      , Ha^Fma      , Ha^Fma      , Ai          , Ai          , Ms          , Ms          , Ms          , Cud         , Ms          , Ms          , Ms          , Ms          , Ms          
Gg          , Gg          , Gs^Fmf      , Gs^Fmf      , Gg^Ve       , Gs^Fmf      , Gs^Fmf      , Ce          , Ce          , Ce          , Gs^Fmf      , Gg          , Gg          , Gg          , Gg          , Gs^Fmf      , Ha^Fma      , Gs^Fmf      , Gs^Fdw      , Gg          , Gg          , Gs^Fmw      , Ww          , Ai          , Ai          , Ms          , Ms          , Cud         , Cud         , Cud         , Ms          , Ms          , Ms          , Ms          
Gg          , Gg          , Gg          , Gs^Fms      , Gs^Fmf      , Gs^Fmf      , Gs^Fmf      , Gs^Fmf      , Hh^Fmf      , Aa^Fma      , Aa^Fma      , Gg          , Gg          , Gg          , Gs^Fdw      , Gs^Fmf      , Ha^Fma      , Hh^Fmf      , Gs^Fmw      , Gs^Fmw      , Gg^Vc       , Gs^Fmw      , Ww          , Ai          , Aa          , Ha^Fma      , Ms          , Cud         , Cud         , Cud         , Ms          , Ha^Vca      , Ms          , Ms          
Gs^Fmf      , Gg          , Gg          , Gs^Fmf      , Gs^Fdw      , Gs^Fmf      , Gs^Fmf      , Aa^Fma      , Ha^Fma      , Ha^Fma      , Gs^Fmf      , Gs^Fdw      , Gg          , Aa          , Gg          , Hh^Fmf      , Hh^Fmf      , Ww          , Ww          , Gs^Fmw      , Gs^Fmw      , Gs^Fmw      , Ww          , Ww          , Gs^Fdw      , Hh^Fmf      , Hh^Fmf      , Ms          , Ha^Fma      , Cud         , Cud         , Ms          , Ms          , Ms          
Gs^Fmf      , Gg          , Gs          , Gg          , Gs^Fdw      , Gs^Fdw      , Gs^Fmf      , Ha^Fma      , Ha^Fma      , Ha^Fma      , Gs^Fmf      , Gs^Fmf      , Gg          , Aa          , Gg          , Gs^Fdw      , Gs^Fmf      , Gs^Fmf      , Gg          , Ww          , Ww          , Ww          , Gs^Fmw      , Gs^Fmw      , Gg          , Gs^Fdw      , Ww          , Ha^Fma      , Cud         , Cud         , Ms          , Ms          , Ms          , Ms          
Gg          , Gs          , Gs          , Gg          , Gg          , Gs^Fmf      , Gg          , Gg          , Gg          , Gg          , Gs^Fmf      , Gs^Fmf      , Gs^Fms      , Gg          , Ss          , Gg          , Gg          , Ce          , Gs          , Ww          , Ha^Fma      , Hh^Fmf      , Hh          , Gg          , Gg^Vc       , Gg          , Ww          , Hh^Fdw      , Ww          , Ha^Fma      , Cud         , Ms          , Ms          , Ms          
Gg          , Gg          , Gg^Vo       , Gg          , Gg          , Gg          , Gs^Fmf      , Gs^Fmf      , Gg          , Gg          , Gg          , Gs^Fmw      , Gg          , Gg          , Ww          , Ww          , Ww          , Gs          , Ww          , Ww          , Hh^Fmf      , Ha^Fma      , Hh          , Gg          , Gg          , Gg          , Gs          , Ww          , Ss          , Cud         , 2 Kud       , Cud         , Ms          , Ms          
Gg          , Gg          , Gg          , Gg          , Aa          , Gg          , Gg          , Gg          , Gs^Fdw      , Gs^Fmf      , Ce          , Ce          , Gg          , Gg          , Ww          , Gg          , Gg^Vc       , Ww          , Ss          , Gs^Fmf      , Gs^Fmf      , Hh          , Gg          , Gg          , Gs^Fmf      , Gg          , Gs          , Ai          , Ss          , Cud         , Cud         , Cud         , Ms          , Ms          
Gs^Fmf      , Gg          , Gg          , Gg          , Aa          , Aa^Fpa      , Gg          , Gg          , Gg          , Gg          , Ce          , Ke          , Gg          , Ww          , Gs^Fms      , Gg          , Gg          , Gg          , Gg          , Ss          , Gg          , Gg          , Gg          , Gg          , Gs^Fmw      , Gs^Fmf      , Ww          , Ai          , Ss          , Hh^Fdw      , Ms          , Ms          , Ms          , Ms          
Gs^Fmf      , Gs^Fmf      , Gg          , Gg          , Gg          , Aa^Fpa      , Gg          , Gs          , Gs          , Gg          , Gg          , Gg          , Ww          , Ww^Bw\      , Gg          , Gg          , Gg          , Gs^Fmf      , Gs^Fmf      , Gg          , Gg          , Gg          , Gs^Fmf      , Ce          , Gg          , Gs^Fmf      , Ww          , Ww          , Ai          , Hh^Fdw      , Ms          , Ms          , Ms          , Ms          
Gg          , Gg          , Gg          , Gg          , Gg          , Gg          , Gs          , Gs          , Gs          , Gg          , Gs^Fmf      , Gs^Fmf      , Ww          , Gg          , Gs          , Gs          , Gg          , Gs^Fmf      , Gg          , Gg          , Gg          , Gs^Fmf      , Gs^Fmf      , Ss          , Ai          , Ww          , Gg^Vc       , Ww          , Gs^Fdw      , Hh^Fmf      , Ha^Fma      , Ms          , Ms          , Ms          
Gg          , Gg          , Gs^Fmf      , Gs^Fmf      , Gs^Fmw      , Gg          , Gs          , Gs          , Gs          , Gg          , Ss          , Ww          , Gs^Fmf      , Gg          , Ce          , Gs          , Gs          , Gg          , Gg          , Gg          , Gg          , Gs^Fmf      , Ss          , Ss          , Ss          , Ww          , Gg          , Ww          , Ww          , Hh^Fmf      , Ms          , Ms          , Ms          , Ms          
Gg          , Gs^Fmf      , Gs^Fmf      , Gs^Fmf      , Gg          , Gg          , Gs          , Gs          , Gs          , Gs          , Ss          , Ww          , Ss          , Gs^Fmf      , Ce          , Ke          , Gs          , Gg          , Aa^Fpa      , Aa^Fpa      , Gs          , Gs          , Ss          , Ha^Fma      , Ha^Fma      , Gs^Fmf      , Gs^Fmf      , Gs^Fmf      , Gs^Fmf      , Hh^Fmf      , Ms          , Ms          , Ms          , Ms          
Gg          , Gg          , Gg          , Gg          , Gg          , Gg          , Gg          , Gs          , Ss          , Ss          , Ss          , Ss          , Ss          , Ss          , Gs          , Ce          , Gs          , Ss          , Ss          , Aa^Fpa      , Ss          , Ss^Bw|      , Ss          , Gs^Fmf      , Aa          , Gs^Fmf      , Ha^Fpa      , Hh^Fmf      , Ha^Fma      , Ha^Fma      , Ha^Fma      , Ms          , Ms          , Ms          
Gg          , Gg          , Gg          , Gg          , Aa^Fpa      , Aa^Fpa      , Gg          , Gs          , Gs          , Gs          , Gg          , Gg          , Gg          , Ss          , Ss          , Gs          , Ss          , Ss          , Ww          , Ss          , Ww          , Ww^Bw|      , Gg          , Gg          , Gg^Vc       , Aa          , Ha^Fpa      , Ms          , Ha^Fma      , Ms          , Ha^Fma      , Ms          , Ms          , Ms          
Gg          , Gg          , Gs          , Gg          , Gg          , Aa^Fpa      , Gg          , Gs          , Gs          , Gg          , Gs^Fmf      , Gg          , Gs^Fmf      , Gs^Fms      , Ss          , Ss          , Ss          , Ww          , Ss          , Ww          , Gs^Fmf      , Gg          , Gs^Fmf      , Gg          , Gg          , Aa          , Aa^Fda      , Ha^Fma      , Aa^Fda      , Ha^Fma      , Ha^Fma      , Ha^Fma      , Ha^Fma      , Ms          
Gg          , Gs          , Gs          , Gg          , Gg          , Gg          , Gg          , Gg          , Gg          , Gg          , Gs^Fmf      , Gs^Fmf      , Ww          , Gs^Fms      , Ww          , Ww          , Ss          , Ss          , Gg          , Gg          , Gs^Fmf      , Gs^Fmf      , Ha^Fma      , Hh^Fmf      , Ha^Fpa      , Ha^Fpa      , Ha^Fma      , Aa^Fma      , Aa^Fma      , Aa^Fda      , Aa^Fda      , Ha^Vca      , Aa^Fma      , Ha^Fma      
Gg          , 1 Gs        , Gs          , Gs          , Gg          , Gg          , Gg          , Gg^Vc       , Gg          , Gg          , Gg          , Gg          , Gg          , Ww          , Gg          , Gg          , Gg          , Gg          , Gs^Fmf      , Gs^Fmf      , Gs^Fmf      , Ha^Fma      , Ms          , Ms          , Ms          , Ms          , Ms          , Aa^Fma      , Aa^Fma      , Aa^Fma      , Aa^Fda      , Aa^Fda      , Aa^Fma      , Aa^Fma      
Gg          , Gg          , Gg          , Gg          , Gs^Fmw      , Gg          , Gg          , Gg          , Gg          , Gg          , Ss          , Gg          , Ww          , Ww^Bw\      , Gg          , Gg^Vh       , Gg          , Gg          , Gg          , Gg          , Gg          , Ha^Fma      , Ha^Fma      , Ha^Fma      , Ha^Fma      , Ha^Fma      , Ha^Fma      , Aa^Fma      , Gg          , Aa^Fda      , Aa          , Aa          , Gg          , Aa^Fma      
Gg          , Gg          , Gg          , Gs^Fmw      , Gs^Fmw      , Gs^Fmw      , Gg          , Gg          , Gg          , Ss          , Ss          , Ww          , Gg          , Gg          , Gg          , Gg          , Aa          , Aa          , Aa          , Aa          , Aa          , Gg          , Gg          , Aa^Fpa      , Gg          , Aa^Fpa      , Gg          , Gg          , Gg          , Gg          , Aa          , Aa^Fpa      , Gg          , Gg          
