border_size=1
usage=map

Wo          , Wo          , Wot         , Wot         , Wo^Br/      , Ww^Br/      , Ww          , Ds          , Ds          , Ds          , Ds          , Ds          , Ds          , Ds          , Ds          , Ds          , Xu          , Xu          , Ww          , Ww          , Wo          , Ww          , Ww          , Xu          , Xu          , Xu          , Xu          , Xu          , Xu          , Xu          , Ss          , Uu          , Uu          , Uu          , Uu          , Uu          , Uu          , Xu          
Ww          , Wwt         , Wwt         , Wot^Br/     , Wot         , Wo          , Ww          , Ds          , Ds          , Ds          , Dd^Vdt      , Ds          , Ds          , Ds          , Ww          , Ww          , Ww          , Ww          , Wo          , Wo          , Ww          , Ww          , Ww^Vm       , Ww          , Xu          , Ss          , Ss          , Ss          , Uu          , Ss          , Uu          , Uu          , Urb         , Uu^Uf       , Urb         , Uu          , Uu          , Xu          
Ww          , Wwt         , Ww^Br/      , Wo^Br|      , Wo          , Wo          , Wo          , Wwf         , Wwf         , Ds          , Ds          , Ds          , Wwf         , Wwf         , Wo          , Ww          , Wo          , Wo          , Ww          , Ww          , Ww          , Ww          , Ww          , Ww          , Xu          , Ss          , Uu          , Uu          , Uu^Vu       , Uu          , Urb         , Urb         , Urb         , Urb         , Urb         , Cud         , Urb         , Xu          
Ds^Br/      , Ww^Br/      , Ds          , Ww          , Wwf         , Wo          , Wo^Bw/      , Wo^Bw/      , Wo          , Wwf         , Wwf         , Wwf         , Wo          , Wo^Bw\      , Wo^Bw\      , Wo          , Ww          , Ww          , Cud         , Wwf         , Cud         , Wwf         , Cud         , Wwf         , Wwf         , Uu          , Cud         , Uu          , Uu          , Uu          , Urb         , Urb         , Cud         , Cud         , Cud         , Urb         , Urb         , Xu          
Dd          , Ds          , Dd^Vdt      , Ds          , Wwf         , Wwf         , Wwf         , Wo          , Wo          , Wo          , Wo          , Wo          , Ww          , Wo          , Wwf         , Wo^Bw\      , Cud         , Cud         , Cud         , Wwf         , Ww          , Wwf         , Ww          , Wwf         , Xu          , Uu          , Ur          , Urb         , Urb         , Urb         , Urb         , Urb         , Cud         , 2 Kud       , Cud         , Urb         , Urb         , Xu          
Ds          , Ds          , Ds          , Ds          , Ds          , Wwf         , Wwf         , Ww          , Wo          , Wot         , Wo          , Wo          , Ww          , Ww          , Wwf         , Wwf         , Ww          , Ww          , Cud         , Ww          , Wo          , Wo          , Ww          , Xu          , Ss          , Ss          , Uu          , Uu          , Uu          , Urb         , Urb         , Urb         , Urb         , Cud         , Urb         , Urb         , Urb         , Xu          
Xu          , Ds          , Xu          , Ds          , Ds          , Wwf         , Wwf         , Ww          , Ww          , Wo          , Ww          , Ww          , Ww^Vm       , Wwf         , Wwf         , Wwf         , Ss          , Ss          , Ss          , Ss          , Ww          , Ww          , Ww          , Xu          , Xu          , Ss          , Uu          , Uu^Vu       , Uu          , Urb         , Urb         , Urb         , Urb         , Urb         , Urb         , Urb         , Urb         , Xu          
Xu          , Xu          , Uu          , Xu          , Wwf         , Wwf         , Wwf         , Wwf         , Ww          , Ww          , Ww          , Wwf         , Wwf         , Wwf         , Wwf         , Xu          , Ss          , Ss          , Ss          , Ss          , Ss^Vhs      , Ss          , Ss          , Xu          , Uu          , Xu          , Xu          , Uu          , Urb         , Urb         , Urb         , Urb         , Uu          , Uu          , Uu          , Urb         , Urb         , Xu          
Xu          , Uh          , Uu          , Xu          , Wwf         , Wwf         , Ww          , Ww          , Wo          , Wwf         , Ww          , Ww          , Ss          , Ss          , Wwf         , Xu          , Xu          , Ss          , Ss          , Wwf         , Wwf         , Wwf         , Wwf         , Wwf         , Wwf         , Xu          , Ww          , Xu          , Xu          , Urb         , Cud         , Urb         , Uu          , Uu^Vu       , Uu          , Urb         , Urb         , Xu          
Xu          , Uu          , Uu          , Xu          , Wwf         , Wwf         , Ww          , Ww^Vm       , Wo          , Wo          , Ww          , Ss          , Ss          , Wwf         , Ww          , Ww          , Xu          , Uu          , Ss          , Ww          , Ww          , Wo          , Wo          , Wo          , Wo          , Wwf         , Wo          , Ww          , Wwf         , Xu          , Uu          , Uu          , Uu          , Uu          , Urb         , Urb         , Xu          , Xu          
Xu          , Uu          , Uu          , Xu          , Xu          , Wwf         , Wwf         , Ww          , Wo          , Wo          , Wo          , Wwf         , Ww          , Ww          , Ww          , Ww          , Xu          , Uu          , Ss          , Ss          , Ww          , Wo          , Wo          , Wo          , Wo          , Wo          , Wo          , Wo          , Wo          , Wwf         , Wwf         , Uu          , Uu          , Cud         , Xu          , Xu          , Ss          , Xu          
Xu          , Cud         , Cud         , Cud         , Xu          , Wwf         , Ww          , Wwf         , Wwf         , Wwf         , Wo          , Wo          , Wo          , Wo          , Ww          , Xu          , Ss          , Uu          , Ss          , Ww^Vm       , Ss          , Wwf         , Ss          , Wwf         , Ss          , Wwf         , Wwf         , Wo          , Wwf         , Wwf         , Uu          , Uu          , Uu          , Xu          , Xu          , Ss          , Uu          , Uu          
Xu          , Cud         , Urb         , Cud         , Xu          , Wwf         , Wwf         , Wwf         , Wo^Bw|      , Wo          , Wo          , Wo          , Ww          , Ww          , Ww          , Xu          , Xu          , Ss          , Xu          , Ss          , Xu          , Ss          , Xu          , Ss          , Xu          , Xu          , Uu          , Wwf         , Xu          , Xu          , Uu          , Uu^Vu       , Uu          , Xu          , Ss          , Uu          , Wwf         , Wwf         
Xu          , Urb         , Xu          , Xu          , Wwf         , Wwf         , Wo          , Wo          , Wo^Bw|      , Wo          , Wwf         , Wwf         , Wwf         , Wwf         , Xu          , Xu          , Uh          , Xu          , Uu          , Xu          , Uu          , Xu          , Uu          , Xu          , Uh          , Xu          , Xu          , Xu          , Ss          , Xu          , Xu          , Uu          , Xu          , Xu          , Ss          , Uu          , Wwf         , Uu          
Xu          , Urb         , Xu          , Ss          , Ss          , Wwf         , Wwf         , Wwf         , Wwf         , Wwf         , Xu          , Xu          , Xu          , Xu          , Uu          , Uu          , Uu          , Uu          , Uu          , Ss          , Ss^Vhs      , Ss          , Ss          , Ur          , Ur          , Uu          , Ur          , Uu          , Ss          , Ss          , Xu          , Ww          , Xu          , Ss          , Uu^Uf       , Ss          , Wwf         , Xu          
Xu          , Xu          , Ss          , Ss          , Cud         , Uu          , Uu          , Uu          , Uu          , Wwf         , Xu          , Uu          , Xu          , Uu          , Ww          , Uu          , Wwf         , Uu^Uf       , Wwf         , Ss          , Wwf         , Ss          , Wwf         , Uu^Uf       , Ur          , Ss          , Ss          , Uu^Vu       , Wwf         , Uu          , Xu          , Cud         , Ur          , Xu          , Uu          , Ww          , Ww          , Xu          
Xu          , Ss          , Ss          , Cud         , 3 Kud       , Cud         , Uu          , Uu^Vu       , Uu          , Ss          , Uu^Uf       , Uu          , Wwf         , Wwf         , Uu^Vud      , Wwf         , Ur          , Wwf         , Uu          , Wwf         , Ur          , Wwf         , Uu          , Xu          , Uu          , Ur          , Wwf         , Wwf         , Uu          , Uu          , Uh          , Xu          , Ur          , Xu          , Uu          , Uu^Vud      , Wwf         , Xu          
Xu          , Uu          , Uu          , Cud         , Cud         , Cud         , Ss          , Uu          , Uu          , Ss          , Wwf         , Wwf         , Ur          , Uu          , Uu          , Uu          , Uu          , Xu          , Uu          , Xu          , Uu          , Uu          , Uh          , Xu          , Uh          , Ur          , Ur          , Ur          , Uu          , Uu          , Xu          , Xu          , Ur          , Xu          , Ss          , Uu          , Wwf         , Xu          
Xu          , Uu          , Uu          , Uu          , Uu          , Uu          , Ss          , Uu^Uf       , Xu          , Ss          , Xu          , Ur          , Xu          , Uh          , Xu          , Xu          , Xu          , Xu          , Xu          , Xu          , Xu          , Xu          , Xu          , Xu          , Xu          , Xu          , Xu          , Uh          , Xu          , Uu          , Xu          , Ur          , Xu          , Xu          , Ss          , Ss          , Wwf         , Xu          
Xu          , Uu          , Xu          , Uu          , Xu          , Uu          , Xu          , Xu          , Uu          , Xu          , Uu          , Xu          , Iwr         , Xu          , Iwr         , Iwr         , Iwr         , Iwr         , Iwr         , Iwr         , Iwr         , Iwr         , Iwr         , Iwr         , Iwr         , Iwr         , Iwr         , Uu          , Cud         , Xu          , Xu          , Xu          , Ss          , Ss          , Ss          , Wwf         , Ss          , Xu          
Xuc         , Xu          , Xuc         , Xu          , Xuc         , Xu          , Iwr         , Iwr         , Iwr         , Iwr         , Iwr         , Iwr         , Cud         , Iwr         , Iwr         , Iwr         , Iwr         , Cud         , Uu^Vud      , Cud         , Iwr         , Cud         , Uu^Vud      , Cud         , Iwr         , Iwr         , Iwr         , Iwr         , Iwr         , Cud         , Xu          , Ss          , Ww^Vm       , Ww          , Wwf         , Wwf         , Ss          , Xu          
Xuc         , Xuc         , Cud         , Xuc         , Iwr         , Iwr         , Cud         , Cud         , Cud         , Iwr         , Cud         , Cud         , Uu^Vud      , Cud         , Cud         , Iwr         , Cud         , Cud         , Cud         , Cud         , Cud         , Cud         , Cud         , Cud         , Iwr         , Iwr         , Iwr         , Iwr         , Iwr         , Cud         , Xu          , Ww          , Ww          , Ss          , Ss          , Wwf         , Ss          , Xu          
Xuc         , Xuc         , Iwr         , Iwr         , Iwr         , Iwr         , Cud         , Uu^Vud      , Cud         , Iwr         , Cud         , Cud         , Cud         , Cud         , Cud         , Cud         , Xu          , Xu          , Xu          , Xu          , Xu          , Xu          , Xu          , Cud         , Cud         , Iwr         , Iwr         , Iwr         , Kud         , Cud         , Cud         , Xu          , Xuce        , Uu          , Uu          , Ur          , Uu          , Xu          
Xuc         , Xuc         , Iwr         , Iwr         , 1 Iwr       , Iwr         , Iwr         , Cud         , Iwr         , Iwr         , Iwr         , Iwr         , Iwr         , Iwr         , Cud         , Xu          , Cud         , Cud         , Cud         , Cud         , Cud         , Cud         , Cud         , Xu          , Cud         , Iwr         , Iwr         , Iwr         , Iwr         , Iwr         , Iwr         , Cud         , Xuce        , Uu          , Uu          , Re          , Uu          , Xu          
Xuc         , Iwr         , Iwr         , Iwr         , Iwr         , Iwr         , Iwr         , Iwr         , Iwr         , Iwr         , Iwr         , Iwr         , Iwr         , Cud         , Xu          , Xu          , Cud         , Cud         , Cud         , Cud         , Cud         , Cud         , Cud         , Xu          , Xu          , Cud         , Iwr         , Iwr         , Uu          , Iwr         , Iwr         , Iwr         , Ur          , Ur          , Re          , Re          , Uu          , Xu          
Uu          , Iwr         , Iwr         , Iwr         , Iwr         , Iwr         , Iwr         , Iwr         , Iwr         , Iwr         , Iwr         , Iwr         , Uu          , Cud         , Xu          , Cud         , Cud         , Cud         , Cud         , Cud         , Cud         , Cud         , Cud         , Cud         , Xu          , Cud         , Iwr         , Uu          , Uu^Vud      , Uu          , Iwr         , Iwr         , Xu          , Ur          , Uu          , Uu          , Uu          , Xu          
Uu          , Uu          , Uu          , Iwr         , Iwr         , Iwr         , Uu          , Uu          , Uu          , Cud         , Kud         , Cud         , Uu          , Uu          , Xu          , Cud         , Cud         , Cud         , Cud         , Cud         , Cud         , Cud         , Cud         , Cud         , Xu          , Cud         , Cud         , Uu          , Uu          , Uu          , Cud         , Cud         , Xu          , Uu          , Uu          , Uu          , Uu          , Xu          
Uu          , Uu          , Uu          , Uu          , Cud         , Xu          , Xu          , Xu          , Xu          , Xu          , Xu          , Xu          , Xu          , Xu          , Xu          , Xu          , Xu          , Xu          , Xu          , Xu          , Xu          , Xu          , Xu          , Xu          , Xu          , Xu          , Xu          , Xu          , Xu          , Xu          , Xu          , Xu          , Xu          , Xu          , Xu          , Xu          , Xu          , Xu          
