border_size=1
usage=map

Rd          , Ds          , Ds          , Xu          , Xu          , Xu          , Xu          , Xu          , Xu          , Xu          , Xu          , Xu          , Xu          , Ww          , Ww          , Wo          , Wo          , Wo          , Wo          , Ww          , Ww          , Xu          , Xu          , Xu          , Xu          , Xu          , Xu          , Xu          , Xu          , Xu          
Ds          , Rd          , Rd          , Ds          , Ds          , Xu          , Xu          , Xu          , Xu          , Xu          , Hd          , Xu          , Hd          , Xu          , Xu          , Ww          , Ww          , Ww          , Ww          , Wo          , Wo          , Ww          , Ww          , Xu          , Uu          , Uu          , Ur          , Xu          , Xu          , Xu          
Ds          , Ds          , Ds          , Rd          , Ds          , Hd          , Xu          , Xu          , Ds          , Ds          , Ds          , Hd          , Ds          , Ds          , Ds          , Xu          , Xu          , Xu          , Xu          , Ww          , Ww          , Wo          , Wo          , Wwf         , Xu          , Xu          , Ur          , Xuc         , Xu          , Xu          
Ds          , Ds          , Ds          , Rd          , Rd          , Ds          , Ds          , Xu          , Ds          , Dd^Vdt      , Ds          , Ds          , Ds          , Dd^Vdt      , Ds          , Hd          , Ds          , Ds          , Ds          , Ww          , Xu          , Ww          , Wo          , Wwf         , Xu          , Xu          , Rr          , Xu          , Xu          , Xu          
Ds          , Dd^Dc       , Ds          , Ds          , Ds          , Rd          , Rd          , Ds          , Rd          , Ds          , Rd          , Ds          , Rd          , Ds          , Rd          , Ds          , Ds          , Dd^Do       , Ds          , Ds          , Xu          , Ww          , Wo          , Wwf         , Xu          , Rr          , Rr          , Rr          , Xu          , Xu          
Ds          , Ds          , Dd^Vo       , Ds          , Ds          , Ds          , Ds          , Rd          , Ds          , Rd          , Ds          , Rd          , Ds          , Rd          , Ds          , Rd          , Rd          , Ds          , Rd          , Ds          , Wwf         , Ww          , Wo          , Wwf         , Xu          , Rr          , Rr          , Rr          , Xu          , Xu          
Ds          , Ds          , Ds          , Ds          , Co          , Ds          , Ds          , Ds          , Dd^Dc       , Ds^Dr       , Dd          , Ds          , Ds          , Ds          , Hd          , Ds          , Ds          , Rd          , Ds          , Rd          , Ww^Bw\      , Wo          , Wwf         , Wwf         , Xu          , Xu          , Xu          , Xu          , Xu          , Xu          
Ds          , Ds          , Ds          , Co          , 3 Kud       , Co          , Ds          , Ds          , Ds          , Ds          , Hd          , Hd          , Hd          , Hd          , Xu          , Hd          , Ds          , Ds^Dr       , Ds          , Ds          , Wwf         , Wo^Bw\      , Ww^Bw\      , Ur          , Ur          , Uu          , Uu          , Xu          , Xu          , Xu          
Ds          , Ds          , Ds          , Co          , Co          , Co          , Ds          , Dd^Vo       , Ds          , Hd          , Xu          , Xu          , Xu          , Xu          , Ww          , Xu          , Wwr         , Wwr         , Xu          , Xu          , Ww          , Wo          , Wwf         , Ur          , Uh          , Ur          , Ur^Vud      , Uu          , Uu          , Xu          
Ds          , Ds          , Ds          , Ds          , Ds          , Ds          , Ds          , Ds          , Xu          , Xu          , Ww          , Ww          , Ww          , Ww          , Ww          , Xu          , Xu          , Wwr         , Ww          , Ww          , Wo          , Wo          , Wwf         , Xu          , Xu          , Ur          , Ur          , Ur          , Ur          , Uu          
Ds          , Ds          , Dd^Vo       , Ds          , Ds          , Dd^Vo       , Ds          , Hd          , Xu          , Ww          , Chw         , Chw         , Chw         , Wo          , Wo          , Ww          , Ww          , Ww          , Wo          , Wo          , Ww          , Ww          , Ww          , Wwf         , Xu          , Ur          , Ur          , Ur          , Ur          , Ur          
Ds          , Ds          , Ds          , Ds          , Ds          , Ds          , Xu          , Xu          , Ww          , Ww          , Chw         , 4 Khw       , Chw         , Wo          , Wwr         , Wo          , Wo          , Wo          , Ww          , Ww          , Xu          , Xu          , Ww          , Wwf         , Xu          , Ur          , Ur          , Ur^Vud      , Uu          , Uu          
Xu          , Xu          , Xu          , Xu          , Xu          , Hd          , Xu          , Ww          , Wo          , Wo          , Ww          , Chw         , Ww          , Wwr         , Wwr         , Ww          , Ww          , Ww          , Xu          , Xu          , Wwr         , Wwr         , Ww          , Ww          , Xu          , Uh          , Ur          , Uu          , Xu          , Xu          
Ds          , Ds          , Ds          , Ds          , Ww          , Xu          , Ww          , Ww          , Wo          , Ww          , Wwr         , Wwr         , Wwf         , Ww          , Wwf         , Wwf         , Xu          , Xu          , Ds          , Xu          , Xu          , Wwr         , Ww          , Xu          , Uu^Uf       , Uu          , Ur          , Uh          , Xu          , Xu          
Ww          , Ww          , Ww          , Ww          , Ww          , Ww          , Wo          , Wo          , Ww          , Ww          , Ds          , Wwf         , Ds          , Ds          , Ds          , Wwf         , Ds          , Ds          , Ds          , Dd^Vdt      , Xu          , Wwr         , Wwf         , Ds          , Ds          , Ur          , Xu          , Xu          , Xu          , Xu          
Ww          , Ww^Vm       , Ww          , Ww          , Wo          , Wo          , Ww          , Ww          , Wwr         , Wwf         , Ds          , Dd^Vdt      , Ds          , Xu          , Ds          , Ds          , Xu          , Xu          , Ds          , Ds          , Xu          , Wwf         , Hd          , Dd^Vdt      , Ds          , Ur          , Cud         , 2 Kud       , Xu          , Xu          
Ww          , Ww          , Wo          , Wo          , Ww          , Wo          , Ww          , Wwr         , Wwf         , Wwf         , Ds          , Ds          , Xu          , Xu          , Xu          , Xu          , Rd          , Rd          , Ds          , Sm          , Wwf         , Xu          , Xu          , Ds          , Ds          , Ur          , Uh          , Cud         , Xu          , Xu          
Wo          , Wo          , Ww          , Ww          , Ww          , Ww          , Xu          , Ds          , Ds          , Ds          , Xu          , Xu          , Rd          , Ds          , Ds          , Rd          , Wwf         , Wwf         , Sm          , Xu          , Sm          , Wwf         , Xu          , Ds          , Uu          , Ur          , Uu^Uf       , Uu^Uf       , Xu          , Xu          
Ww          , Ww          , Ww          , Ww^Vm       , Ww          , Xu          , Ds          , Ds          , Ds          , Xu          , Rd          , Rd          , Uu          , Ur^Vud      , Ur          , Xu          , Xu          , Wwf         , Wwf         , Xu          , Sm^Vud      , Wwf         , Sm          , Xu          , Xu          , Ur          , Ur          , Uu          , Uu          , Xu          
Ww          , Ww          , Ds          , Ww          , Xu          , Xu          , Ds          , Ds          , Ds          , Ds          , Uu          , Xu          , Xu          , Uu          , Wwf         , Sm          , Xu          , Uu^Uf       , Ur          , Xu          , Xu          , Wwf         , Wwf         , Uu          , Xu          , Uu          , Ss          , Re          , Uu          , Xu          
Ww          , Ww          , Ds          , Ds          , Xu          , Ds          , Xu          , Xu          , Ds          , Ds          , Xu          , Ur          , Uu          , Xu          , Uu^Uf       , Wwf         , Xu          , Uu          , Wwf         , Ur^Vud      , Xu          , Uu^Uf       , Uu          , Uu          , Re          , Uu          , Re          , Re          , Uu          , Xu          
Ww          , Ww          , Ds          , Xu          , Wwf         , Wwf         , Xu          , Ds          , Dd^Vdt      , Ds          , Xu          , Ur          , Ur          , Xu          , Uu          , Wwf         , Sm          , Wwf         , Ur          , Wwf         , Wwf         , Xu          , Xu          , Uu          , Uu          , Re          , Uu^Uf       , Re          , Uu          , Xu          
Ww          , Ds          , Ds          , Xu          , Wwf         , Xu          , Wwf         , Wwf         , Ds          , Ds          , Xu          , Uu          , Ur          , Xu          , Xu          , Uu          , Uu          , Ur          , Xu          , Uu          , Re          , Uu          , Uu          , Xu          , Uu^Vud      , Uu          , Xu          , Uh          , Xu          , Xu          
Ww          , Ds          , Xu          , Xu          , Wwf         , Wwf         , Xu          , Wwf         , Wwf         , Xu          , Sm          , Ur          , Ur          , Ur^Vu       , Xu          , Wwf         , Wwf         , Ur^Vud      , Uu          , Xu          , Xu          , Re          , Wwf         , Xu          , Xu          , Xu          , Ur          , Xu          , Xu          , Xu          
Ww          , Ww          , Xu          , Wwf         , Wwf         , Xu          , Wwf         , Wwf         , Ds          , Ds          , Ur          , Ur          , Xu          , Xu          , Xu          , Xu          , Xu          , Wwf         , Wwf         , Wwf         , Xu          , Wwf         , Sm          , Wwf         , Wwf         , Xu          , Cud         , Ur          , Xu          , Xu          
Ww          , Ww          , Wwf         , Wwf         , Xu          , Xu          , Wwf         , Wwf         , Xu          , Uu          , Ur          , Sm          , Xu          , Cud         , Uh          , Uu^Uf       , Ur          , Xu          , Uu          , Uu          , Re          , Xu          , Re          , Wwf         , Uu^Uf       , Xu          , Xu          , Ur          , Xu          , Xu          
Ww          , Ww          , Ww          , Xu          , Sm          , Wwf         , Wwf         , Wwf         , Xu          , Uu          , Ur          , Sm          , Xu          , Uu          , Sm          , Uu          , Ur^Vud      , Xu          , Xu          , Re          , Xu          , Re          , Wwf         , Wwf         , Wwf         , Sm          , Sm          , Xu          , Xu          , Xu          
Wo          , Ww^Vm       , Ww          , Xu          , Sm          , Wwf         , Xu          , Xu          , Uu          , Ur          , Ur^Vu       , Uu          , Xu          , Sm          , Sm          , Uu          , Ur          , Uu          , Ur          , Xu          , Re          , Re          , Xu          , Xu          , Wwf         , Uu          , Uu^Vud      , Uu          , Xu          , Xu          
Wo          , Ww          , Xu          , Xu          , Wwf         , Wwf         , Xu          , Uu          , Ur          , Ur          , Xu          , Xu          , Ww          , Xu          , Xu          , Sm          , Sm          , Ur          , Uu          , Ur          , Xu          , Xu          , Wwf         , Wwf         , Uu          , Sm          , Xu          , Uh          , Xu          , Xu          
Ww          , Ww          , Xu          , Ds          , Ds          , Ds          , Xu          , Uu^Uf       , Ur          , Uu          , Xu          , Wwf         , Xu          , Wwf         , Cud         , Xu          , Xu          , Xu          , Xu          , Uu          , Xu          , Re          , Sm          , Sm          , Uu          , Xu          , Uu          , Xu          , Xu          , Xu          
Xu          , Xu          , Uu          , Uu          , Uu          , Xu          , Uh          , Uu          , Ur          , Uu          , Xu          , Sm          , Wwf         , Xu          , Uu          , Rr          , Rr          , Rr          , Uu          , Xu          , Xu          , Re          , Re          , Re          , Re          , Uu^Uf       , Uu          , Uh          , Xu          , Xu          
Ql          , Ql          , Uu          , Uu^Vu       , Uu          , Uu^Uf       , Ur^Vu       , Ur          , Ur^Vu       , Uu          , Cud         , Xu          , Ur          , Xu          , Xu          , Rr          , Rr          , Rr          , Rr          , Uu          , Uu          , Xu          , Xu          , Xu          , Re          , Re          , Uu          , Uu          , Xu          , Xu          
Ql          , Ql          , Ql          , Uu          , Ur          , Ur          , Cud         , Cud         , Cud         , Cud         , Xu          , Xu          , Ur          , Ur          , Xu          , Ss          , Rr          , Rr^Vud      , Rr          , Rr          , Rr          , Uu          , Xu          , Sm          , Re          , Re          , Cud         , Cud         , Xu          , Xu          
Ql          , Uu          , Ur          , Ql^Bs/      , Uu          , Uu          , Xu          , Xu          , Xu          , 5 Kud       , Xu          , Ur^Vud      , Ur          , Xu          , Ss          , Ss          , Rr          , Rr          , Rr          , Rr^Vud      , Rr          , Uu          , Xu          , Sm          , Wwf         , Re          , Cud         , Kud         , Xu          , Xu          
Uu          , Uu          , Ur          , Ql          , Ur          , Uu^Uf       , Uu          , Uu          , Uh          , Xu          , Ur          , Ur          , Xu          , Xu          , Ss          , Uu          , Re          , Rr          , Re          , Rr          , Uu          , Uu          , Xu          , Sm          , Wwf         , Wwf         , Cud         , Cud         , Ur          , Uu          
Ur          , Uu          , Ur          , Ql          , Uu          , Cud         , Uu          , Uu^Vu       , Ql          , Xu          , Ur          , Wwf         , Xu          , Ss          , Ur          , Re          , 1 Ur        , Re          , Uu          , Re          , Re          , Xu          , Xu          , Sm          , Re          , Xu          , Xu          , Xu          , Uu          , Ur          
Uu          , Ur          , Ur          , Ql          , Ql          , Uu          , Ql          , Uu          , Ql          , Uu^Uf       , Ur          , Ur          , Xu          , Ss          , Ss          , Re          , Re          , Uu          , Ss          , Ss          , Ss          , Re          , Re          , Ss          , Re          , Re          , Sm          , Xu          , Uh          , Uu          
Uu          , Uu          , Ur          , Uu          , Ql          , Ql          , Ur          , Ql          , Ur          , Ur          , Uu          , Uu          , Ds          , Xu          , Ss          , Uu          , Re          , Uu          , Uu          , Xu          , Xu          , Ss          , Ss          , Re          , Uu          , Uu          , Uu^Vud      , Xu          , Uu          , Uu          
Ql          , Uu^Uf       , Ur          , Uu          , Ur          , Ur          , Ql          , Ur          , Ql          , Ql          , Ql          , Ds          , Ds          , Xu          , Xu          , Uu          , Uu          , Re          , Uu          , Ss          , Xu          , Xu          , Xu          , Uu          , Xu          , Xu          , Xu          , Xu          , Uu          , Uu          
Ql          , Uu          , Ur^Vud      , Ur          , Uu          , Ur          , Ql          , Ql          , Ds          , Ql          , Ds          , Ds          , Dd^Vdt      , Ds          , Hd          , Xu          , Uu          , Re          , Re          , Ss          , Ss          , Ss          , Uu          , Xu          , Uu^Uf       , Uh          , Uu          , Uu          , Uu          , Uh          
Ql          , Uu          , Uu          , Uu          , Ql          , Ql          , Ds          , Ds          , Dd^Vdt      , Ds          , Hd          , Ds          , Ds          , Ds          , Hd          , Xu          , Xu          , Uu          , Uu          , Re          , Re          , Re          , Re          , Uu          , Uu          , Uu          , Uu          , Uu^Vud      , Uu          , Uh          
Ql          , Ql          , Uu          , Uu          , Ql          , Ql          , Ds          , Ds          , Ds          , Ds          , Hd          , Hd          , Hd          , Hd          , Md          , Md          , Md          , Xu          , Xu          , Uu          , Uu          , Uu          , Uu          , Re          , Re          , Uu          , Uu          , Uu          , Xu          , Xu          
