border_size=1
usage=map

Gs          , Gs          , Aa          , Aa          , Ha^Fpa      , Ha          , Ha          , Ai          , Ai          , Ms          , Ai          , Ai          , Ai          , Ha^Fma      , Ha^Fpa      , Ms          , Ms          , Ms          , Ha^Fma      , Ms          , Ha^Fma      , Aa          , Ai          , Ai          , Ha^Fma      , Aa          , Aa          , Aa          , Gs          , Gs          , Gs          , Aa          , Gs          , Gs          , Gs          , Ds          , Ds          , Ww          , Ww          , Ww          , Wo          , Wo          , Ww          , Ww          , Ww          , Ds          
Gs          , Gs          , Gs          , Aa          , Aa          , Ha^Fpa      , Ha^Fpa      , Ha^Vaa      , Ha^Fpa      , Ai          , Ha^Fma      , Ha^Fma      , Ai          , Aa          , Ha^Fma      , Ha^Fma      , Ha^Fpa      , Ha^Fma      , Aa          , Ha^Fma      , Aa          , Aa          , Ai          , Aa          , Aa^Fda      , Aa          , Aa^Fda      , Gs          , Gs          , Gs^Vht      , Gs          , Gs          , Ds          , Gs          , Ds          , Ds          , Ww          , Ww          , Ww          , Ww          , Wo          , Ww          , Ww          , Ww          , Ds          , Ds          
Aa          , Aa          , Gs          , Aa          , Aa          , Hh^Fdw      , Hh^Fdw      , Ha^Fpa      , Hh^Fdw      , Ha^Fma      , Aa^Fma      , Aa^Fma      , Ai          , Aa          , Aa          , Aa          , Aa          , Aa          , Aa          , Aa          , Aa          , Aa^Fda      , Ww          , Aa^Fda      , Gs          , Aa^Fda      , Gs          , Gs          , Gs          , Ds          , Ds          , Ds          , Ww          , Ds          , Ww          , Ww          , Ww          , Ww          , Wo          , Wo          , Ww          , Ww          , Ww          , Ds          , Ds          , Ds          
Gs          , Gs          , Aa^Fma      , Gs          , Gs          , Gs          , Hh^Fdw      , Hh^Fdw      , Aa          , Ha^Fpa      , Ww          , Ai          , Ai          , Aa          , Aa          , Rd          , Aa          , Aa^Vaa      , Aa          , Aa          , Gs          , Gs          , Ss          , Gs          , Ss          , Gs          , Gs          , Gs          , Ds          , Ds          , Ds          , Ds          , Ww          , Ww          , Ww          , Ww          , Wo          , Wo          , Ww          , Ww          , Ww          , Ww          , Ds          , Ww          , Ss          , Ds          
Gg          , Aa^Fma      , Aa^Fma      , Aa          , Gs^Fmf      , Gs          , Gs          , Gs          , Aa          , Aa          , Ss          , Ai          , Ss          , Ai          , Rd          , Rd          , Aa          , Aa          , Aa^Fpa      , Aa^Fpa      , Gs          , Ss          , Ss          , Ss          , Ss^Vhs      , Ss          , Gs          , Gs          , Ds          , Ds          , Ww          , Ww          , Ww          , Ww          , Wo          , Wo          , Wo          , Wo          , Wo          , Ww          , Ww          , Ds          , Ds          , Ds          , Ss          , Ss          
Gg          , Gg          , Aa^Fma      , Gs^Fmf      , Aa^Fma      , Aa          , Aa^Fma      , Aa          , Aa^Fma      , Ss          , Ss^Vhs      , Ss          , Ss          , Ss          , Rd          , Aa          , Aa          , Aa^Fma      , Gs^Fmf      , Aa^Fma      , Gs          , Gs^Fmf      , Ss          , Ss          , Ds          , Ss          , Ds          , Ds          , Ds          , Ds          , Ww          , Ww          , Ww          , Wo          , Wo          , Wo          , Wo          , Ww          , Ww          , Ww          , Ds          , Ds          , Ss          , Ss          , Ds          , Ds          
Gg          , Gg^Vo       , Aa          , Gs^Fmf      , Aa          , Aa^Fma      , Gs^Fmf      , Aa^Fma      , Ss          , Ss          , Ss          , Aa          , Rd          , Ss^Bw/      , Ss          , Aa          , Ss          , Aa^Fma      , Gs          , Gs          , Gs          , Gs          , Ss          , Ss          , Ss          , Ds          , Ds          , Ds          , Ww          , Ww          , Ww          , Ww          , Wo          , Wo          , Wo          , Ww          , Ww          , Ww          , Ds          , Ww          , Ds          , Ss^Vm       , Ww          , Ds          , Hd          , Hd          
Aa          , Gg          , Gs          , Aa          , Aa^Fma      , Aa^Fma      , Ss          , Ss          , Aa^Fda      , Aa^Fda      , Aa          , Aa          , Aa          , Aa          , Ss          , Ss          , Ss          , Gs          , Ds          , Gs          , Ds          , Ds          , Ss          , Ss          , Ww          , Ds          , Ww          , Ww          , Ww          , Ww          , Ww^Vm       , Ww          , Wo          , Wo          , Ww          , Ww          , Ww          , Ww          , Ds          , Ds          , Ds          , Ds          , Hd          , Ww          , Hd          , Md          
Gg          , Gg          , Aa          , Aa          , Ss          , Ss          , Aa^Fda      , Ss          , Aa          , Aa          , Rd          , Rd          , Aa          , Aa          , Aa          , Ss          , Ss          , Ds          , Ds          , Ds          , Ds          , Ss          , Ww          , Ss          , Ww          , Ww          , Ww          , Ww          , Ww          , Ww          , Wo          , Wo          , Wot         , Wo          , Ww          , Ww          , Ss          , Ds          , Ds          , Ds          , Hd          , Hd          , Md          , Hd          , Md          , Md          
Rd          , Gg          , Aa          , Ai          , Aa          , Aa          , Aa          , Aa^Fda      , Rd          , Aa          , Aa          , Aa          , Aa          , Aa          , Aa^Voa      , Aa          , Ds          , Ss          , Ww          , Ww          , Wwf         , Ww          , Ww          , Ww          , Ww          , Wo          , Wo          , Wo          , Wo          , Wo          , Wo          , 1 Wot       , Wo          , Wo          , Ww          , Ww          , Ss          , Ds          , Ds          , Hd          , Md          , Md          , Hd          , Hd          , Hd          , Hd          
Gs          , Rd          , Ai^Bw\      , Ai          , Aa          , Aa          , Aa          , Aa          , Rd          , Aa          , Gs          , Gs          , Gs          , Aa          , Aa          , Aa          , Ds          , Ds          , Ww          , Ww          , Wwf         , Ww          , Wo          , Wo          , Wo          , Wo          , Wot         , Wot         , Wot         , Wo          , Ww          , Wo          , Ww          , Ww          , Ww          , Ss          , Ss^Vhs      , Ds          , Ds          , Hd          , Md          , Hd          , Ds          , Ds          , Ds          , Ds          
Ai          , Aa          , Ss          , Aa          , Aa          , Rd          , Rd          , Aa          , Aa          , Gs          , Ss          , Ds          , Ds          , Ds          , Ds          , Ds          , Wwf         , Ww          , Wwf         , Wwf         , Ww          , Ww          , Wwt         , Wwt         , Wwt         , Wot         , Wo          , Wo          , Wo          , Wo          , Ww          , Ww          , Ww          , Ww          , Ds          , Ds          , Ss          , Ss          , Ds          , Hd          , Md          , Hd          , Ds          , Dd^Vht      , Ds          , Ds          
Gs          , Ss          , Gs          , Gs          , Co          , Coa         , Coa         , Aa          , Gg          , Gg          , Gg          , Ss          , Ss          , Wwf         , Wwf         , Ds          , Wwf         , Ww          , Wwf         , Ww^Vm       , Ww          , Wwt         , Wwt         , Wot         , Wot         , Wot         , Wo          , Ww          , Wwf         , Ww          , Wwf         , Wwf         , Wwf         , Ds          , Dd^Dc       , Ds          , Ss          , Ds          , Hd          , Hd          , Md          , Hd          , Ds          , Ds          , Ds          , Ss          
Gs          , Ss          , Ss          , Gs          , Chr         , 3 Koa       , Co          , Aa          , Gs          , Gg^Vo       , Gg          , Ss          , Ww          , Ww          , Wwf         , Wwf         , Wwr         , Wwf         , Wwr         , Wwr         , Wwt         , Wwt         , Wot         , Wot         , Wot         , Wo          , Ww          , Ww          , Wwf         , Wwf         , Ww          , Wwf         , Ds          , Ds          , Ds          , Ds          , Ds          , Ds          , Hd          , Md          , Md          , Hd          , Hd          , Ds          , Ds          , Ss          
Ss          , Ss          , Rp          , Rp          , Rp          , Chr         , Rp          , Gs          , Ss          , Gg          , Ss          , Ss          , Ww          , Wwf         , Wwr         , Wwr         , Wwrt        , Wwr         , Wwt         , Wwt         , Wot         , Wot         , Wot         , Wot         , Wo          , Wo          , Wwf         , Wwf         , Ww          , Ww          , Ss          , Ds          , Ds          , Dd^Vht      , Ds          , Ds          , Ds          , Hd          , Md          , Md          , Md          , Md          , Hd          , Ds          , Ss          , Ss          
Ss          , Ss          , Ww          , Rp          , Rp          , Rp          , Rp          , Ss          , Ss          , Ss          , Ww          , Ww          , Wwr         , Wwr         , Wwt         , Wwt         , Wwt         , Wwt         , Wwt         , Wwt         , Wot         , Wot         , Khw         , Chw         , Ww          , Ww^Vm       , Wwf         , Ww          , Wwf         , Wwf         , Ss          , Ss          , Ss          , Ds          , Ss          , Ds          , Ds          , Hd          , Hd          , Md          , Md          , Md          , Hd          , Ds          , Ds          , Ss          
Ww          , Ww          , Ww          , Ww^Bw/      , Ww^Bw/      , Rp          , Ds          , Gs          , Ss          , Ss          , Ww          , Wwr         , Wwrt        , Wwt         , Wot         , Wot         , Wot         , Wot         , Wot         , Wwrt        , Chw         , Chw         , Wwt         , Ww          , Wwrg        , Ww          , Wwf         , Ds          , Ds          , Ds          , Ds          , Ds          , Ds          , Ss          , Ds          , Ds          , Hd          , Hd          , Md          , Md          , Hd          , Hd          , Ds          , Ds          , Ww          , Ss          
Wwt         , Ww          , Ww          , Ww          , Ww          , Ds          , Dd^Vo       , Ds          , Ww          , Ww          , Wwt         , Wwt         , Wwrt        , Wwrt        , Wot         , Wot         , Wot         , Wot         , Wot         , Chw         , Wot         , Wot         , Wwrt        , Wwr         , Ww          , Wwf         , Ww          , Wwf         , Wwf         , Ds          , Ds          , Ds^Dr       , Ds          , Ds          , Hd          , Ds          , Hd          , Hd          , Md          , Hd          , Hd          , Ds          , Ss          , Ss^Vht      , Ww          , Ds          
Wot         , Wwt         , Wwt         , Ww          , Wwf         , Ds          , Ds          , Ds          , Ww          , Ww          , Wwt         , Wot         , Wot         , Wwrt        , Wwrt        , Wwt         , Wot         , Wot         , Wot         , Wot         , Wot         , Wwt         , Wwrt        , Ww          , Wwf         , Wwf         , Wwf         , Wwf         , Ds          , Ds          , Ds          , Ds          , Ce          , Ce          , Ce          , Hd          , Hd          , Md          , Hd          , Md          , Hd          , Ds          , Ds          , Ss          , Ds          , Ds          
Wot         , Wot         , Wwt         , Wwt         , Ww          , Ds          , Ds          , Ww          , Wwrt        , Wwt         , Wot         , Wot         , Ww^Vm       , Wwrt        , Chw         , Chw         , Wot         , Wot         , Wot         , Wot         , Wot         , Wot         , Wwt         , Ww          , Wwf         , Ww          , Wwf         , Wwf         , Ds          , Ds          , Ds          , Ds          , Ce          , 4 Ke        , Ce          , Hd          , Ds          , Hd          , Hd          , Md          , Md          , Hd          , Ds          , Ss          , Ss          , Ds          
Wot         , Wot         , Wot         , Wot         , Wwt         , Ww          , Ww          , Ww          , Wwrt        , Wwrt        , Wot         , Wot         , Wot         , Wot         , Chw         , 2 Khw       , Chw         , Chw         , Wot         , Wot         , Wot         , Wwt         , Wot         , Ww          , Ww          , Ww          , Ww          , Wwf         , Ww          , Ds          , Rd          , Rd          , Ds          , Ce          , Ds          , Ds          , Ds          , Ds          , Ds          , Hd          , Md          , Hd          , Ds          , Ds          , Ss          , Ds          
Wot         , Wot         , Wot         , Wot         , Wot         , Wot         , Wwt         , Wwrt        , Wwrt        , Wot         , Wot         , Wot         , Wot         , Wot         , Wwrt        , Chw         , Wot         , Wot         , Wot         , Wot         , Wot         , Wot         , Wot         , Wwt         , Wwt         , Wwt         , Wwt         , Ww          , Ww          , Ds          , Rd          , Ds          , Ds          , Ds          , Ds          , Ds          , Ds          , Ds          , Ds          , Hd          , Hd          , Hd          , Ds          , Ss          , Ds          , Ds          
Wot         , Wot         , Wot         , Ww^Vm       , Wot         , Wot         , Wot         , Wot         , Wwrt        , Wwrt        , Wot         , Wwrt        , Wwrt        , Wwrt        , Wwrt        , Wwrt        , Ww^Vm       , Wot         , Wot         , Wwrt        , Wot         , Wot         , Wot         , Wot         , Wot         , Wot         , Wot         , Wwt         , Ww          , Ww^Bw/      , Rd          , Ds          , Ds^Dr       , Ds          , Ds          , Dd^Vdt      , Ds          , Ds          , Ds          , Hd          , Ds          , Ds          , Ss          , Ss          , Ds          , Ds          
Wot         , Wot         , Wot         , Wot         , Wot         , Wot         , Wot         , Wot         , Wot         , Wot         , Wot         , Wot         , Wwrt        , Wot         , Wot         , Wot         , Wot         , Wot         , Wot         , Wwrt        , Wwrt        , Wot         , Wot         , Wot         , Ww^Vm       , Wot         , Wot         , Wwt         , Ww          , Ww^Bw/      , Ds          , Ds          , Ds          , Ds          , Ds          , Ds          , Ds          , Ds          , Ds          , Ds          , Ds          , Ds          , Ss          , Ds          , Ds          , Ds          
Wot         , Wot         , Wot         , Wot         , Wwrt        , Wwrt        , Wot         , Wot         , Wot         , Wot         , Wot         , Wot         , Wot         , Wot         , Wot         , Wot         , Wot         , Wot         , Wot         , Wwrt        , Wot         , Wot         , Wot         , Wot         , Wot         , Wot         , Wot         , Wwt         , Wwt         , Ww          , Ww          , Ds          , Ds          , Ds          , Ss          , Ss          , Ss          , Ss          , Ss          , Ss          , Ss          , Ss          , Ss^Vhs      , Ss          , Ds          , Ds          
Wo          , Wot         , Wot         , Wot         , Wo          , Wot         , Wot         , Wot         , Wot         , Wot         , Wot         , Wot         , Wot         , Wot         , Wot         , Wot         , Wot         , Wot         , Wot         , Wot         , Wot         , Wot         , Wot         , Wot         , Wot         , Wot         , Wot         , Wot         , Wo          , Wwt         , Wwt         , Ww          , Ds          , Ds          , Ds          , Ds          , Ds          , Ds          , Ds          , Ss          , Ss          , Ss          , Ss          , Ss          , Ss          , Ss          
