border_size=1
usage=map

Wwrt        , Wwrt        , Wwrt        , Wot         , Wot         , Wot         , Wot         , Wot         , Wot         , Wot         , Wot         , Wot         , Wot         , Wot         , Wot         , Wot         , Wot         , Wot         , Wot         , Wo          , Wot         , Wot         , Wot         , Wot         , Wot         , Wot         , Wot         , Wot         , Wot         , Wot         , Wot         
Wwrt        , Wwrt        , Wot         , Wot         , Wwrt        , Wot         , Wot         , Wot         , Wot         , Wot         , Wot         , Wot         , Wot         , Wot         , Wot         , Wot         , Wot         , Wot         , Wot         , Wwrt        , Wwrt        , Wot         , Wot         , Wot         , Wot         , Wot         , Wot         , Wot         , Wot         , Wot         , Wot         
Wwrt        , Wot         , Wwt         , Wwrt        , Wwrt        , Wot         , Wwrt        , Wot         , Wot         , Wot         , Wot         , Wwrt        , Wwrt        , Wot         , Wot         , Wot         , Wwrt        , Wot         , Wot         , Wwrt        , Wot         , Wot         , Wot         , Wot         , Wot         , Wot         , Wot         , Wot         , Wot         , Wot         , Wot         
Wot         , Wwrt        , Wwrt        , Wot         , Ww^Vm       , Wwrt        , Ww^Vm       , Wot         , Wot         , Wot         , Wot         , Wot         , Wwrt        , Wwrt        , Wwrt        , Wwrt        , Wwrt        , Wwrt        , Wwrt        , Wot         , Wwrt        , Wot         , Wwrt        , Wot         , Wwrt        , Wot         , 1 Wot       , Wot         , Wot         , Wot         , Wot         
Wot         , Wot         , Wwrt        , Wot         , Wot         , Wot         , Wot         , Wwrt        , Wot         , Wot         , Wot         , Wwrt        , Wot         , Wwrt        , Wot         , Wwrt        , Wot         , Wot         , Wot         , Wot         , Wot         , Wwrt        , Wwrt        , Wwrt        , Wot         , Wot         , Wot         , Wot         , Wot         , Wot         , Wot         
Wot         , Wwrt        , Wwrt        , Wot         , Wwrt        , Wwrt        , Wwrt        , Wwrt        , Wwrt        , Wot         , Wot         , Wot         , Wot         , Ww^Vm       , Wot         , Wot         , Wot         , Wot         , Wot         , Wot         , Wot         , Wot         , Wwrt        , Wot         , Wot         , Wot         , Wwrt        , Wot         , Wwrt        , Wot         , Wot         
Wot         , Wot         , Wwrt        , Wot         , Wwrt        , Wwrt        , Wwrt        , Chw         , Chw         , Chw         , Khw         , Wwrt        , Wwrt        , Wot         , Wwf         , Wot         , Wot         , Wot         , Wot         , Wot         , Wot         , Wwrt        , Wwrt        , Wwrt        , Wot         , Wot         , Wwrt        , Wwrt        , Wwrt        , Wot         , Wot         
Wot         , Wot         , Ww^Vm       , Wwt         , Ww^Vm       , Wwt         , Wwf         , Chw         , Dd^Do       , Wwt         , Chw         , Chw         , Ds          , Wwf         , Hd          , Ds          , Ds          , Wot         , Wot         , Wot         , Wot         , Wot         , Wwrt        , Wwrt        , Wwrt        , Wwrt        , Wwrt        , Ww^Vm       , Wwrt        , Wot         , Wot         
Wot         , Wot         , Wwrt        , Wot         , Wot         , Wwt         , Wwt         , Wwf         , Wwf         , Ds          , Ds          , Ds          , Hd          , Hd          , Md^Xm       , Hd          , Hd          , Wot         , Wot         , Wot         , Wot         , Wot         , Wot         , Wot         , Wot         , Wot         , Wot         , Wwrt        , Wot         , Wot         , Wot         
Wot         , Wwrt        , Wot         , Wot         , Wot         , Wwrt        , Wwt         , Ds          , Ds          , Ds          , Hd          , Hd          , Md^Xm       , Md^Xm       , Wwrt        , Md^Xm       , Md^Xm       , Hd          , Wot         , Wot         , Wot         , Wot         , Wot         , Wot         , Wot         , Wot         , Wot         , Wot         , Wot         , Wot         , Wot         
Wot         , Wwrt        , Wot         , Wot         , Wot         , Wwrt        , Ds          , Ds          , Hd          , Hd          , Md^Xm       , Md^Xm       , Hd          , Wot         , Wot         , Wwrt        , Md^Xm       , Hd          , Hd          , Wot         , Wot         , Wot         , Wot         , Wot         , Wot         , Wot         , Wot         , Wot         , Wot         , Wot         , Hd          
Wot         , Wwrt        , Wot         , Wwrt        , Wot         , Wot         , Ds          , Hd          , Md          , Md^Xm       , Hd          , Hd          , Wwrt        , Wot         , Wot         , Wwrt        , Hd          , Md^Xm       , Md^Xm       , Hd          , Hd          , Hd          , Hd          , Wot         , Wot         , Wot         , Wot         , Wot         , Hd          , Hd          , Md^Xm       
Wot         , Wot         , Wot         , Wot         , Wot         , Wwrt        , Ds          , Ds          , Hd          , Md^Xm       , Hd          , Wwrt        , Wot         , Wot         , Wwt         , Ds          , Hd          , Dd^Vdt      , Hd          , Md^Xm       , Md^Xm       , Md^Xm       , Md^Xm       , Hd          , Hd          , Hd          , Md          , Hd          , Md^Xm       , Md^Xm       , Hd          
Wot         , Wot         , Wot         , Ww^Vm       , Wot         , Wot         , Wot         , Ds          , Hd          , Md^Xm       , Hd          , Wwrt        , Wwrt        , Wot         , Wwrt        , Wwrt        , Wwrt        , Ds          , Ww          , Ww          , Wwrt        , Wwt         , Wwt         , Md^Xm       , Md^Xm       , Md^Xm       , Md^Xm       , Md^Xm       , Hd          , Hd          , Wot         
Wot         , Wot         , Wwrt        , Wwrt        , Wot         , Wot         , Wot         , Ds          , Hd          , Md^Xm       , Hd          , Hd          , Wwt         , Wwrt        , Wot         , Wwrt        , Wot         , Wwrt        , Wwrt        , Wwrt        , Wot         , Wot         , Wwrt        , Wwrt        , Hd          , Dd^Vdt      , Hd          , Hd          , Wwrt        , Wot         , Wot         
Wot         , Wot         , Wot         , Wwrt        , Wot         , Wot         , Wwrt        , Ds          , Hd          , Md^Xm       , Hd          , Wot         , Wot         , Wwrt        , Wwrt        , Wot         , Wot         , Wot         , Wot         , Wwrt        , Wwrt        , Wot         , Wwrt        , Wwrt        , Wot         , Wwrt        , Wwt         , Wwrt        , Wwrt        , Wwrt        , Wot         
Wot         , Wot         , Wot         , Wot         , Wot         , Wot         , Wot         , Ds          , Wwrt        , Hd          , Wwrt        , Wot         , Wot         , Wwrt        , Wwt         , Wot         , Wwt         , Wot         , Wwt         , Wot         , Wwrt        , Wwrt        , Wot         , Wot         , Wot         , Wwrt        , Wwrt        , Wwrt        , Wot         , Wwrt        , Wot         
Wwt         , Wwf         , Wwt         , Wot         , Wot         , Wot         , Wot         , Wot         , Wot         , Wwrt        , Ww^Vm       , Wwrt        , Wwrt        , Wwrt        , Wwrt        , Wwt         , Wwrt        , Wwt         , Wwf         , Wwf         , Wwrt        , Wwt         , Wwt         , Wot         , Wwt         , Wwt         , Wwrt        , Wot         , Wot         , Ww^Vm       , Wot         
Wwt         , Wwt         , Wwt         , Wot         , Wwt         , Wwrt        , Wwrt        , Wot         , Wot         , Wot         , Wot         , Wot         , Wot         , Wwrt        , Wwrt        , Wwrt        , Wwrt        , Wwrt        , Ds          , Ds          , Ds          , Wwt         , Wwrt        , Wwrt        , Wwrt        , Ds          , Wwt         , Wwrt        , Wwt         , Wot         , Wot         
Ds          , Wwt         , Ds          , Wwt         , Wwt         , Wwt         , Wwt         , Wot         , Wwt         , Wot         , Wot         , Wot         , Wwt         , Wwrt        , Wwt         , Wwrt        , Ds          , Ds          , Hd          , Dd^Vdt      , Ds          , Wwf         , Hd          , Wwrt        , Wwrt        , Wwrt        , Wwrt        , Wwrt        , Wwt         , Wot         , Wot         
Ds          , Ds          , Dd^Vdt      , Ds          , Wwt         , Wwt         , Wwt         , Wwt         , Wwt         , Wwt         , Wwt         , Wwt         , Ds          , Wwt         , Ds          , Ds          , Hd          , Hd          , Md^Xm       , Hd          , Hd          , Hd          , Hd          , Ds          , Wot         , Wot         , Chw         , Chw         , Chw         , Wwrt        , Wwrt        
Hd          , Ds          , Ds          , Ds          , Ds          , Ds          , Ds          , Ds          , Ds          , Ds          , Ds          , Ds          , Hd          , Ds          , Hd          , Hd          , Md^Xm       , Md^Xm       , Hd          , Md^Xm       , Md^Xm       , Md^Xm       , Hd          , Ds          , Wwrt        , Wot         , Chw         , 3 Khw       , Chw         , Wwrt        , Wo          
Hd          , Hd          , Hd          , Hd          , Hd          , Hd          , Hd          , Hd          , Hd          , Hd          , Hd          , Hd          , Md^Xm       , Hd          , Md^Xm       , Md^Xm       , Hd          , Hd          , Ds          , Hd          , Ds          , Hd          , Ds          , Wwrt        , Wwrt        , Wwrt        , Wwrt        , Chw         , Wot         , Wwt         , Wwt         
Md^Xm       , Hd          , Md^Xm       , Md^Xm       , Md^Xm       , Md^Xm       , Md^Xm       , Md^Xm       , Md^Xm       , Md^Xm       , Md^Xm       , Md^Xm       , Hd          , Md^Xm       , Hd          , Hd          , Ds          , Ds          , Ds          , Ds          , Wwrt        , Ds          , Wwrt        , Ww          , Ds          , Wwrt        , Ww^Vm       , Wot         , Wot         , Wot         , Wot         
Hd          , Md^Xm       , Hd          , Hd          , Hd          , Hd          , Hd          , Hd          , Hd          , Hd          , Hd          , Hd          , Ds          , Hd          , Ds          , Ds          , Ds          , Dd^Vda      , Ds          , Wwrt        , Wwrt        , Wwrt        , Wwrt        , Wot         , Wot         , Wwt         , Wwt         , Wot         , Wot         , Wot         , Wot         
Ds          , Hd          , Ds          , Ds          , Ds          , Ds          , Ds          , Ds          , Ds          , Ds          , Ds          , Ds          , Wwrt        , Ds          , Ds          , Wot         , Wot         , Ds          , Wwrt        , Wwrt        , Wwt         , Wot         , Wot         , Wot         , Wwrt        , Wwrt        , Wot         , Wot         , Wwrt        , Wot         , Wot         
Wo          , Ds          , Wwrt        , Wwrt        , Wot         , Wot         , Wot         , Wwf         , Wot         , Wwrt        , Wwrt        , Wwt         , Wwt         , Wwf         , Wwrt        , Wot         , Wwt         , Wwrt        , Wot         , Wwt         , Wot         , Wot         , Wwt         , Wwrt        , Wwrt        , Wwrt        , Wot         , Wwrt        , Ww          , Wot         , Wot         
Wo          , Wwrt        , Wwrt        , Wwrt        , Wwrt        , Wot         , Wwrt        , Wwrt        , Wwrt        , Wwrt        , Wwrt        , Wwrt        , Wot         , Wwt         , Wwrt        , Wwrt        , Wwrt        , Wwt         , Wot         , Wwt         , Wwt         , Wot         , Wwt         , Wot         , Wwrt        , Wot         , Wot         , Wwrt        , Ww^Vm       , Wwrt        , Wo          
Wwrt        , Wwt         , Wwrt        , Ww^Vm       , Wot         , Wwrt        , Wot         , Wwrt        , Wot         , Wot         , Wwrt        , Wot         , Wot         , Ds          , Wwrt        , Wwrt        , Wwrt        , Wot         , Wwrt        , Wwrt        , Ds          , Wwt         , Wwrt        , Wot         , Wwrt        , Wwrt        , Wot         , Wot         , Wot         , Wot         , Wot         
Wwrt        , Wwrt        , Wwrt        , Wot         , Wot         , Wot         , Wwrt        , Wwrt        , Wwrt        , Wwrt        , Ww^Vm       , Wwrt        , Wwrt        , Wwrt        , Wwrt        , Wot         , Wot         , Wwrt        , Wwt         , Wwrt        , Wot         , Wot         , Wwrt        , Wwrt        , Wwrt        , Wwrt        , Wwrt        , Wwrt        , Wot         , Wot         , Wot         
Wwrt        , Wwrt        , Wwrt        , Wot         , Wot         , Wot         , Wot         , Wwrt        , Wwt         , Wwrt        , Wwrt        , Wwrt        , Wwrt        , Wwt         , Ds          , Wwrt        , Wot         , Wot         , Wwt         , Wwrt        , Wwrt        , Wwrt        , Wwt         , Wwt         , Wot         , Wot         , Wot         , Wot         , Wot         , Wot         , Wot         
Wot         , Wwt         , Wwrt        , Wwrt        , Chw         , Chw         , Chw         , Wwrt        , Wot         , Ds          , Wwrt        , Wot         , Wot         , Wwt         , Wwt         , Wwrt        , Wot         , Wot         , Wot         , Wwt         , Wwrt        , Wwrt        , Wot         , Wwrt        , Wot         , Wot         , Wot         , Wwrt        , Wwrt        , Wot         , Wot         
Wot         , Wot         , Wot         , Wwrt        , Chw         , 2 Khw       , Chw         , Wot         , Wwrt        , Wwrt        , Wot         , Wot         , Wwt         , Wwt         , Wwrt        , Wot         , Wot         , Wot         , Wot         , Wwrt        , Wot         , Wot         , Wwrt        , Wot         , Wot         , Ww^Vm       , Wwrt        , Wwrt        , Wot         , Wot         , Wot         
Wot         , Wot         , Wot         , Wwrt        , Wwrt        , Chw         , Wot         , Wwrt        , Wwrt        , Wwrt        , Wwrt        , Wot         , Wot         , Wwrt        , Wwrt        , Ww^Vm       , Wot         , Wot         , Wwrt        , Wwrt        , Wot         , Wot         , Wwrt        , Wot         , Wot         , Wot         , Wwrt        , Wwrt        , Wot         , Wot         , Wot         
Wot         , Wot         , Wwrt        , Wwrt        , Wot         , Wot         , Wot         , Wot         , Wot         , Wot         , Wwrt        , Wot         , Wot         , Wot         , Wot         , Wot         , Wot         , Wot         , Wwrt        , Wwrt        , Wwrt        , Wot         , Wot         , Wot         , Wot         , Wwrt        , Wwrt        , Wwrt        , Wwrt        , Wot         , Wot         
Wot         , Wot         , Wo          , Wwrt        , Wot         , Wot         , Wot         , Wot         , Wot         , Wot         , Wo          , Wot         , Wot         , Wot         , Wot         , Wot         , Wot         , Wot         , Wot         , Wot         , Wot         , Wot         , Wot         , Wot         , Wot         , Wot         , Wot         , Wot         , Wot         , Wot         , Wot         
